R 1231 414
WE ./tex/wall_green_tiles.xpm
SO ./tex/brick_wall_texture.xpm
NO ./tex/wall_grey_rock.xpm
EA ./tex/wall_brown_tiles.xpm
S ./tex/sprite.xpm
C 251,255,255
F 0,0,0

        1111111111111111111111111
        1000000000110000000000001
        1011000001110000000000001
        1001000000000000000000001
111111111011000001110000000000001
100000000011000001111111110111111
11110111111111011100000000001
11110111111111011100010000001
11000000110101011100000000001
10000000000000001100000000001
10000000000000001101010000001
11000001110101011100200N00001
11110111 1110101 101111000001
11111111 1111111 1111111111111
